ㄱ = g
ㄴ = n
ㄷ = d
ㄹ = l
ㅁ = m
ㅂ = b
ㅅ = s
ㅇ, last character = ng
ㅇ, first character = 
ㅈ = j
ㅊ = ch
ㅋ = k
ㅌ = t
ㅍ = p
ㅎ = h
ㅏ = a
ㅑ = ya
ㅓ = eo
ㅕ = yeo
ㅗ = o
ㅛ = yo
ㅜ = u
ㅠ = yu
ㅡ = eu
ㅣ = i
ㄲ = gg
ㄸ = dd
ㅃ = bb
ㅆ = ss
ㅉ = jj
ㅐ = ae
ㅒ = yae
ㅔ = e
ㅖ = ye
ㅚ = oe
ㅙ = wae
ㅟ = wi
ㅞ = we
ㅢ = ui
ㅝ = wo
